11111111111
1C0C111C0C1
10001100001
11100B00111
11110B01111
1EP00B00001
11111111111
