1111111111111
10010000001C1
1000011C00101
1P0011E000011
1000011111001
1111111111111
