11111BB
1PCE001
1000001
1111111
