11111111111
1C0C111C0C1
10001100001
11100100111
11110BB1111
1EP00000001
11111111111
