1111111111
10C00B0001
11111B1111
11111PE111
1111111111
