1111111111111
1E00000000001
1010010100101
1010010010101
100000000C001
1111111111111
