1111111111111
1E00000000001
1010010100101
1010010010101
1000000000001
1111111111111
