11111111
1.011111
1CCEP111
11111111
